OOOOOOORROOOOOOO
OOOOOOORROOOOOOO
OOOOOOORROOOOOOO
OOOOOOOGROOOOOOO
OOOOOOOBROOOOOOO
OOOOOOOBROOOOOOO
